F 76,76,76
C 99,99,50


SO            textures/S.xpm
                               NO textures/N.xpm
WE textures/W.xpm
EA textures/E.xpm

111111
1E0001
100001
100001
111111
   111111 
