F 76,76,76
C 99,99,50

NO textures/N.xpm
SO textures/S.xpm
WE textures/W.xpm
EA textures/E.xpm

111111111111
1W00000000011
100000000001
100000000001
111111111111
