F 255,255,255
C 0,0,51

SO textures/S.xpm
NO textures/N.xpm
WE textures/W.xpm
EA textures/E.xpm

1111111111111111111
1S00000000000000001
1000001111100000001
1000001111100000001
1000001111100000001
1000000000000000001
1111111111111111111
